11111111111
1P0CE000011
11111111111