1111111111111111111
11EPC00100000000001
1111110000000000001
1111110000000000001
1111110000000C00001
1111110000000000001
1111110000000000001
1111111111111111111

