11111111111111111111111111111
11000110101001001010000100101
10001100100010010000001110001
10100010110000000000000000111
10000100000000000100100000001
10000000000000001000000110011
10000010101000101000001000001
11000010001000100011000010101
10010001000111000000011101001
10100000010110101000100010011
10100000000011001000000000111
11110000011001010100000000001
10010000100100110010010100101
10000100000000010010100000011
11000000101000110000100000001
10000011101100001011101000001
10100011C00010100100001000011
10001000100001000001000010101
10010111000000000000001010111
11100010000000100100101101101
10000000011000010100000000001
10C1101001100100011001011E011
11101000000010000010011010011
10011010110100001000010000001
11000000001011010000100000001
11000100000000000000000C00001
11000011100100011000011000011
10110001001000100000000100011
10000001000101100011110000001
10011000001101011011111010001
10111001001010110010001000111
10000010111000010000111000001
10101001000001000000010110101
11000100101P01000010001101011
11111111111111111111111111111
