11111111111111111111
10100110010010111011
1C100100000000010011
10000000010110000011
10111101100111100011
11000000000010100101
10111010110011110011
10100000100010000011
10100100000011101001
10010010000010011001
10P01C11C11001101001
11000E01001100011011
10000001010101010001
11110010001101010101
10100011101110000011
11110011010101000011
10011011000100001011
11001000001001010111
11001000011111001001
10000101101010001011
10000100000001001001
10011000100100000101
10001101000010110001
11111111111111111111
