1111111111111111111111111111111
1P00001000000001000001000000001
1001001111001111111001111001111
1001000001000000000001000000001
1111111001111001111001111111001
1000000001000001000001001000001
1111001111111001111111001111001
1000001001000001000001000000001
1001111001111001111001111C01111
10000C1000001000001001000000001
1111001111001111001001111001111
1000001000000000C00000000001001
1001111001111111111111111001001
1001001000001001001000001000001
1001001001111001001111001001111
1000001000000001001000000000001
1001111001111111001111111111001
10010010010000000000C1001000001
1001001001111111001111001001C01
10000000000000000000000010010E1
1111111111111111111111111111111
