1111111111111111111111111111
1E0000000000000C00000C000001
1010010100100000101001000001
1010010010101010001001000001
1P0000000C00C0000000000000C1
1100001000111111111111111111
110C100000001000011111111111
1000000000000000111111111111
1111111111111111111111111111