1111111111111
10010000000C1
10000111110001
1P0011E0000011
1111111101111