1111
1P01
10C1
1E01111111111111
1111